{
	"voxels": [
		[[0, 0, 0, 0, 0, 0, 0, 0, 0, 0, 0, 0]
		,[0, 0, 0, 0, 0, 0, 0, 0, 0, 0, 0, 0]
		,[0, 0, 0, 0, 0, 0, 0, 0, 0, 0, 0, 0]
		,[0, 0, 0, 0, 0, 0, 0, 0, 0, 0, 0, 0]
		,[0, 0, 0, 0, 0, 0, 0, 0, 0, 0, 0, 0]
		,[0, 0, 0, 0, 0, 0, 0, 0, 0, 0, 0, 0]
		,[0, 0, 0, 0, 0, 0, 0, 0, 0, 0, 0, 0]
		,[0, 0, 0, 0, 0, 0, 0, 0, 0, 0, 0, 0]
		,[0, 0, 0, 0, 0, 0, 0, 0, 0, 0, 0, 0]
		,[0, 0, 0, 0, 0, 0, 0, 0, 0, 0, 0, 0]
		,[0, 0, 0, 0, 0, 0, 0, 0, 0, 0, 0, 0]
		,[1, 1, 1, 1, 1, 1, 1, 1, 1, 1, 1, 1]]
		,
		[[0, 0, 0, 0, 0, 0, 0, 0, 0, 0, 0, 0]
		,[0, 0, 0, 0, 0, 0, 0, 0, 0, 0, 0, 0]
		,[0, 0, 0, 0, 0, 0, 0, 0, 0, 0, 0, 0]
		,[0, 0, 0, 0, 0, 0, 0, 0, 0, 0, 0, 0]
		,[0, 0, 0, 0, 0, 0, 0, 0, 0, 0, 0, 0]
		,[0, 0, 0, 0, 0, 0, 0, 0, 0, 0, 0, 0]
		,[0, 0, 0, 0, 0, 0, 0, 0, 0, 0, 0, 0]
		,[0, 0, 0, 0, 0, 0, 0, 0, 0, 0, 0, 0]
		,[0, 0, 0, 0, 0, 0, 0, 0, 0, 0, 0, 0]
		,[0, 0, 0, 0, 0, 0, 0, 0, 0, 0, 0, 0]
		,[1, 1, 1, 1, 1, 1, 1, 1, 1, 1, 1, 1]
		,[0, 0, 0, 0, 0, 0, 0, 0, 0, 0, 0, 0]]
		,
		[[0, 0, 0, 0, 0, 0, 0, 0, 0, 0, 0, 0]
		,[0, 0, 0, 0, 0, 0, 0, 0, 0, 0, 0, 0]
		,[0, 0, 0, 0, 0, 0, 0, 0, 0, 0, 0, 0]
		,[0, 0, 0, 0, 0, 0, 0, 0, 0, 0, 0, 0]
		,[0, 0, 0, 0, 0, 0, 0, 0, 0, 0, 0, 0]
		,[0, 0, 0, 0, 0, 0, 0, 0, 0, 0, 0, 0]
		,[0, 0, 0, 0, 0, 0, 0, 0, 0, 0, 0, 0]
		,[0, 0, 0, 0, 0, 0, 0, 0, 0, 0, 0, 0]
		,[0, 0, 0, 0, 0, 0, 0, 0, 0, 0, 0, 0]
		,[1, 1, 1, 1, 1, 1, 1, 1, 1, 1, 1, 1]
		,[0, 0, 0, 0, 0, 0, 0, 0, 0, 0, 0, 0]
		,[0, 0, 0, 0, 0, 0, 0, 0, 0, 0, 0, 0]]
		,
		[[0, 0, 0, 0, 0, 0, 0, 0, 0, 0, 0, 0]
		,[0, 0, 0, 0, 0, 0, 0, 0, 0, 0, 0, 0]
		,[0, 0, 0, 0, 0, 0, 0, 0, 0, 0, 0, 0]
		,[0, 0, 0, 0, 0, 0, 0, 0, 0, 0, 0, 0]
		,[0, 0, 0, 0, 0, 0, 0, 0, 0, 0, 0, 0]
		,[0, 0, 0, 0, 0, 0, 0, 0, 0, 0, 0, 0]
		,[0, 0, 0, 0, 0, 0, 0, 0, 0, 0, 0, 0]
		,[0, 0, 0, 0, 0, 0, 0, 0, 0, 0, 0, 0]
		,[1, 1, 1, 1, 1, 1, 1, 1, 1, 1, 1, 1]
		,[0, 0, 0, 0, 0, 0, 0, 0, 0, 0, 0, 0]
		,[0, 0, 0, 0, 0, 0, 0, 0, 0, 0, 0, 0]
		,[0, 0, 0, 0, 0, 0, 0, 0, 0, 0, 0, 0]]
	],
	"materials": [
		{
			"name": "Air",
			"type": "Empty"
		},
		{
			"name": "Grass",
			"type": "Cube",
			"texture": {
				"left"   : "./usr/lvl/garten/grass_side.png",
				"right"  : "./usr/lvl/garten/grass_side.png",
				"front"  : "./usr/lvl/garten/grass_side.png",
				"back"   : "./usr/lvl/garten/grass_side.png",
				"top"    : "./usr/lvl/garten/grass_top.png",
				"bottom" : "./usr/lvl/garten/dirt.png"
			}
		}
	]
}
